111111
1P1111
10CE11
100001
111111
111111